#################################################
#                                               #
#                                               #
#                                               #
#                                               #
#                                               #
#                                               #
#                                               #     
#                                               #
#                                               #
#                                               #
#                                               #
#                                               #
#                                               #
#                                               #
#                                               #
#                                               #
#                                               #
#                                               #
#                                               #
#                                               #
#                                               #
#                                               #
#                                               #
#                                               #
#                                               #
#                                               #
#                                               #
#                                               #
#                                               #
#                                               #
#                                               #
#                                               #
#                                               #
#                                               #
#                                               #
#                                               #
#                                               #
#                                               #
#                                               #
#                                               #
#                                               #
#                                               #
#                                               #
#                                               #
#                                               #
#                                               #
#                                               #
#                                               #
#################################################